________________________________________
________________________________________
________________________________________
____#______________________________#____
____#______________________________#____
____#______________________________#____
____#___________________________________
____________#___________________________
________________________________________
________________________________________
________________________________________
________________________________________
___________________________#____________
________________________________________
_____#__________________________________
__________####################__________
__________####################__________
________________________________________
________________________________________
________________________________________
_____________________#__________________
________________________________________
________________________________________
__________####################__________
__________####################__________
________________________________________
________________________________________
________________________________________
________#_______________________________
________________________________________
________________________________________
________________________________________
________________________________________
________________________________________
____#______________________________#____
____#______________________________#____
____#______________________________#____
________________________________________
_________F______#_______________________
________________________________________
