________________________________________
________________________________________
________________________________________
____#______________________________#____
____#______________________________#____
____#______________________________#____
________________________________________
______#_________________________________
________________________________________
________________________________________
________________________________________
________________________________________
________________________________________
________________________________________
________________________________________
__________####################__________
__________####################__________
________________________________________
________________________________________
________________________________________
________________________________________
________________________________________
________________________________________
__________####################__________
______#___####################__________
________________________________________
________________________________________
________________________________________
________________________________________
________________________________________
________________________________________
________________________________________
________________________________________
________________________________________
____#______________________________#____
____#________________________#_____#____
____#______________________________#____
________________________________________
_______________F________________________
________________________________________
