_______________#________________________
________________________________________
________________________________________
____#______________________________#____
____#_____#________________________#____
____#______________________________#____
________________________________________
________________________________________
________________________________________
_________#______________________________
___________________#_____________#______
________________________________________
________________________________________
_______________________________#________
___#____________F_______________________
____#_____####################__________
__________####################__________
________________________________________
________________________________________
________________________________________
________________________________________
________________________________________
________________________________________
__________####################__________
__________####################__________
________________________________________
________________________________________
________________________________________
_____________#__________________________
________________________________________
________________________________#_______
________________________________________
______#_______________________________#_
________________________________________
____#____#_________________________#____
____#______________________________#____
____#______________________________#____
________________________________________
________________________________________
________________________________________
