________________________________________
_______________________#________________
________________________________________
____#______________________________#____
____#______________________________#____
____#______________________________#____
________________________________________
________________________________________
________________________________________
________________________________________
__________#_____________________________
________________________________________
________________________________________
________________________________________
________________________________________
__________####################__________
_#________####################__________
_____________________#__________________
_#______________________________________
_________________________#_________F____
________________________________________
________________________________________
________________________________________
__________####################__________
__________####################__________
________________________________________
________________________________________
______#_________________________________
________________________________________
________________________________________
________________________________________
________________________________________
________________________________________
________________________________________
____#______________________________#____
____#______________________________#____
____#______________________________#____
________________________________________
________________________________________
________________________________________
