#######__________________________#######
#______________________________________#
#______________________________________#
#______________________________________#
#______________________________________#
#______________________________________#
#________######__________######________#
#________#____________________#________#
#________#____________________#________#
_________#____________________#________#
_________#____________________#________#
_________######__________######________#
_______________________________________#
_______________________________________#
_______________________________________#
_______________________________________#
_______________________________________#
_______________________________________#
___________##################___________
___________##################___________
_______________________________________#
_______________________________________#
_______________________________________#
_______________________________________#
_______________________________________#
_______________________________________#
_______________________________________#
_________######__________######________#
_________#____________________#________#
_________#____________________#________#
#________#____________________#________#
#________#____________________#________#
#________######__________######________#
#______________________________________#
#______________________________________#
#______________________________________#
#______________________________________#
#______________________________________#
#______________________________________#
#######__________________________#######