________________________________________
________________________________________
________________________________________
____#______________________________#____
____#______________________________#____
____#______________________________#____
________________________________________
________________________________________
________________________________________
________________________________________
________________________________________
________________________________________
________________________________________
________________________________________
________________________________________
__________####################__________
__________####################__________
________________________________________
________________________________________
________________________________________
________________________________________
________________________________________
________________________________________
__________####################__________
__________####################__________
________________________________________
________________________________________
________________________________________
________________________________________
________________________________________
________________________________________
________________________________________
________________________________________
________________________________________
____#______________________________#____
____#______________________________#____
____#______________________________#____
________________________________________
________________________________________
________________________________________