________________________________________
________________________________________
________________________________________
____#______________________________#____
____#______________________________#____
____#____________________________#_#____
________________________________________
________________________________________
________________________________________
________________________________________
_______________#________________________
______________#_________________________
________________________________________
________________________________________
________________________________________
__________####################__________
__________####################__________
________________________________________
__________F_____________________________
________________________________________
________________________________________
________________________________________
__________________________________#_____
__________####################__________
__________####################__________
________________________________________
_______________________________#________
________________________________________
________________________________________
________________________________________
________________________________________
_____________________#__________________
________________________________________
________________#_______________________
____#___#__________________________#____
____#______________________________#____
____#__________________________#___#____
________________________________________
________________________________________
________________________________________
