________________________________________
________________________________________
________________________________________
____#______________________________#____
____#__________#___________________#____
____#___________________#__________#____
________________________________________
________________________________________
________________________________________
________________________________________
________________________________________
F____________________________________#__
________________________________________
________________________________________
________________________________________
__________####################__________
__________####################__________
________________________________________
________________________________________
_______#________________________________
________________________________________
________________________________________
________________________________________
__________####################__________
__________####################__________
__________________________________#_____
________________________________________
________________________________________
________________________________________
________________________________________
________________________________________
________________________________________
________________________________________
________________________________________
____#______________________________#___#
____#______________________________#____
____#______________________________#____
____________________#_________________#_
______________________________________#_
__________________#_____________________
