___________________##___________________
___________________##___________________
___________________##___________________
___________________##___________________
___________________##___________________
___________________##___________________
___________________##___________________
___________________##___________________
___________________##___________________
___________________##___________________
___________________##___________________
___________________##___________________
___________________##___________________
___________________##___________________
___________________##___________________
___________________##___________________
___________________##___________________
#######__##########__########__#########
#######__##########__########__#########
________________________________________
________________________________________
#######__##########__########__#########
#######__##########__########__#########
___________________##___________________
___________________##___________________
___________________##___________________
___________________##___________________
___________________##___________________
___________________##___________________
___________________##___________________
___________________##___________________
___________________##___________________
___________________##___________________
___________________##___________________
___________________##___________________
___________________##___________________
___________________##___________________
___________________##___________________
___________________##___________________
___________________##___________________